"a" = (/turf/simulated/floor/exoplanet/snow,/area/space)
"b" = (/turf/simulated/wall/wood,/area/space)
"c" = (/turf/simulated/floor/plating,/area/space)
"d" = (/turf/simulated/floor/asteroid,/area/space)
"e" = (/turf/simulated/floor/tiled/techfloor,/area/space)
"f" = (/turf/simulated/floor/wood,/area/space)
"g" = (/turf/simulated/wall/r_wall,/area/space)
"h" = (/turf/simulated/floor/exoplanet/grass,/area/space)
"i" = (/turf/simulated/floor/exoplanet/concrete,/area/space)
"j" = (/turf/simulated/floor/tiled/freezer,/area/space)
"k" = (/obj/structure/pit/closed/grave,/obj/structure/gravemarker/cross,/turf/simulated/floor/exoplanet/grass,/area/space)
"l" = (/obj/structure/pit/closed/grave,/obj/structure/gravemarker/cross,/turf/simulated/floor/exoplanet/snow,/area/space)
"m" = (/turf/unsimulated/wall,/area/space)
"n" = (/turf/unsimulated/mineral,/area/space)
"o" = (/turf/simulated/floor/exoplanet/water/shallow,/area/space)
"p" = (/turf/simulated/floor/exoplanet/ice,/area/space)

(1,1,1) = {"
mmmmmmmmmmmmmmmmmmmmmmmmmmmmmmmmmmmmmmmmmmmmmmmmmmmmmmmmmmmmmmmmmmmmmmmmmmmmmmmmmmmmmmmmmmmmmmmmmmmmmmmmmmmmmmmmmmmmmmmmmmmmmmmmmmmmmmmmmmmmmmmmmmmmmm
mnnnnnnnnnnnnnnnnnnnnnnnnnnnnnnnnnnnnnnnnnnnnnnnnnnnnnnnnnnnnnnnnnnahahhaaaaaaaaaaaaaaaaaaaaaaaaaaaaaaahahhhnnnnnnnnnnnnnnnnnnnnnnnnnnnnnnnnnnnnnnnnnm
mnnnnnnnnnnnnnnnnnnnnnnnnnnnnnnnnnnnnnnnnnnnnnnnnnnnnnnnnnnnnnnnnnnahaaaaaaaaaaaaaaaaaaaaaaaaaaaaaaaaaaaaaahnnnnnnnnnnnnnnnnnnddnnnnnnnnnnnnnnnnnnnnnm
mnnnnnnnnnnnnnnnnnnnnnnnnnnnnnnnnnnnnnnnnnnnnnnnnnnnnnnnnnnnnnnnnnhhhaaaaaaaaaaaaaaahaaaaaaaaaaaahhhaaaaahhaaannnnnnnnnnnnnnnnddddnnnnnnnnnnnnnnnnnnnm
mnnnnnnnnnnnnnnnnnnnnnnnnnnnnnnnnnnnnnnnnnnnnnnnnnnnnnnnnnnnnnnnnnahhaaaaaaaaaaaaaaaaaaaaaaaaaaaahhhaaaaaaahhhnnnnnnnnnnnnnnnnddddaadnnnnnnnnnnnnnnnnm
mnnnnnnnnnnnnnnnnnnnnnnnnnnnnnnnnnnnnnnnnnnnnnnnnannnnnnnnnnnnnnhhhhaaaahhaahaaaaahahhaahaaaaaaaahaaaaaaaaahhhnnnnnnnnnnnnndaaaaddadaaaannnnnnnnnnnnnm
mnnnnnnnnnnnnnnnnnnnnnnnnnnnnnnnnnnnnnnnnnnnnnannannnnnnnnnnnnnnhhaahahhhahaaaaaaaaaaaahaaaaaaaaaaaaaaaaaaahhhnnnnnnnnnnnnadaaaannaaaadaannnnnnnnnnnnm
mnnnnnnnnnnnnnnnnnnnnnnnnnnnnnnnnnnnnnnnnnnnhaaaaannnnnnnnnnnnaaaaaaaahhhahaaaaaaaahaaaaaaaaaaaaaahaaaaaaaaaahannnnnnnnnnaaaaaannnnnddddannnnnnnnnnnnm
mnnnnnnnnnnnnnnnnnnnnnnnnnnnnnnnnnnnnnnhnnhhaaaahhaannnnnnnnnnaaaaaaaaaaaaaaaaaaaaaaaaahaaaaaaaaaaaaaaaaaaaahhannnnnnnnnnanadddannddddaaannnnnnnnnnnnm
mnnnnnnnnnnnnnnnnnnnnnnnnnnnnnnnnnnnnnnhnhaaaaaahhaannnnnnnnaaaaaahhaaaaaaaahhaahaaaaaahaaaaaaaahhaaaaaaaaaahhaannnnnnnnnaaaaddadddaddaadannnnnnnnnnnm
mnnnnnnnnnnnnnnnnnnnnnnnnnnnnnnnnnnnnnnhhaaaaaahhaaannnnnnnnnaaaaahhaaaaaaaaaaaaaaaaaaaaaaaaaaaaaaahhaaaaaaahhannnnnnnddaaadadddddddaaaadannnnnnnnnnnm
mnnnnnnnnnnnnnnnnnnnnnnnnnnnnnnnnnnnnnnahaaaaaahhahaannnnnannaaaaahhaaaaaaaaaahhaaaaaaaaaaahaahaaaahaaaaaaaaaahnnnnnndadddannaaaadddadddddannnnnnnnnnm
mnnnnnnnnnnnnnnnnnnnnnnnnnnnnnnnnnnnnnnaaaaaaaahhahhhhaaanaaaaaaahaaaaahhhaaaaaaaaaaaaaaaaaaaaahhaaaaaaaaaaaaaaannnnnddddaannaaaddddndnnnddannnnnnnnnm
mnnnnnnnnnnnnnnnnnnnnnnnnnnnnnnnnnnnnnnhhhaaaaahhaahhhaaaaaaaaaaahaaaaaahhaaaaaaaaaaaaaaaaaaaaahhaaaaaaaaaaahaaanndnaddnnnnnnndaaddaannnnddannnnnnnnnm
mnnnnnnnnnnnnnnnnnnnnnnnnnnnnnnnnnnnnnnhaaaaaaaaaaaaaaaahaaaaahaaaaahaaahhhaaaaaahaaaaaaaaaaaaaaaaaaaaaaaahhaaaaaaddddannnnnnnnaaddannnnnaaannnnnnnnnm
mnnnnnnnnnnnnnnnnnnnnnnnnnnnnnnnnnnnnhaaaaahhhaaaaaaaaaaaaaaaahaaaaaahaaahhaaaaaaahaaaaahhaaaaaaaaaaaaaaahaddddhhhaaddnnnnnnnnnnadaaddnddddannnnnnnnnm
mnnnnnnnnnnnnnnnnnnnnnnnnnnnnnnnnnnnaaaaaaaahhaaaaaaaaaaaaahhhhaaaaaahaaaaaaaahhaahaahaahaaaaaaaaaaaaaaaahhdapppdddddannnnnnnnadaaaaadddaddnnnnnnnnnnm
mnnnnnnnnnnnnnnnnnnnnnnnnnnnnnnnnnnnaaaaahhahaaaaaaaaaahaaaaaahaaaaaaaaaaaaaaahhahhaaaaaaaaaaaaaaaaaaahhahhpppppppddaannnnnnnnddaaaannndnnannnnnnnnnnm
mnnnnnnnnnnnnnnnnnnnnnnnnnnnnnnnnnnnaaaaahhaaaaaaaaaaaahaahaahhaaaaaaaaaaaaaaaaaaaaaaaaaaahhahaaaaaadddahadppppppppddaannnnnddddddnnnnnnnnnnnnnnnnnnnm
mnnnnnnnnnnnnnnnnnnnnnnnnnnnnnnnnnnnaaaaaaaaaahaaaaaaaahaahhhhaahhhaaaaahaahhhaaaaaahhaaahhhhhaaaahaddddddhpppppappdhaaaannnadddannnnnnnnnnnnnnnnnnnnm
mnnnnnnnnnnnnnnnnnnnnnnnnnnnnnnnnnnaaahaaaaahhhaahaaaaaaaaaahhhaaaaaaaaaaaahddddaaahahaaahhaaaaaaahdddppppppppaaaappddahhnadddddnnnnnnnnnnnnnnnnnnnnnm
mnnnnnnnnnnnnnnnnnnnnnnnnnnnaaaaaaaahhhaaaahhhaaaaaaaaaaaaaaaaaaaaaaaaaaahahdddddddaddhaaaaaaaaaaaaddpppppppppaaaappdddhhhddddadnnnnnnnnnnnnnnnnnnnnnm
mnnnnnnnnnnnnnnnnnnnnnnnnnnaahaaaaaahhhhaaahhaaaaaaaaaaaaaaaahaaaaaaaaaadddddhaddddddddaaaaaaaaahhhddppppppppppaaappppppdppddhadnnnnnnnnnnnnnnnnnnnnnm
mnnnnnnnnnnnnnnnnnnnnnnnnnaahhhaahaaahhaaaaaaaaaaaaaaaaaaaaaahaaaaaaaahhddddhaadddddddddahhaaaaaahhppppppppppppappppppppppppddaahnnnnnnnnnnnnnnnnnnnnm
mnnnnnnnnnnnnnnnnnnnnnnnnnnahaaaaahaahhhaaaaaaaaahhaaaaaaaaaaaaaaaaaadddddahhaaddddhhaadaaaaaaaaahdpppppppppppppppapppppppppddhhaannnnnnnnnnnnnnnnnnnm
mnnnnnnnnnnnnnnnnnnnnnnnnnnaaaaaaaaaaahhhaaaaaaaahhaaaaaaaaaaaaaaaaaadddhaaaaaaaahaaaaaaaaaaaaaaahddppppppppppppppppppppppppddddhahdnnnnnnnnnnnnnnnnnm
mnnnnnnnnnnnnnnnnnnnnnnnnnnnaahhaaaaaaahhaaaaaahhaaaaabbbbbaaaaaaaadddddhahaaaaaaaaaaddaaahhaaaahaddpppppppppppappppppppppppppppddddnnnnnnnnnnnnnnnnnm
mnnnnnnnnnnnnnnnnnnnnnnnnnnnnaaaaaaaaaahaaaaahhahaaaaabaaabbcbcbbaadddddhahhhagggggaaddahahdddaahaadddhhpppppppaapppppppppppppppppddnnnnnnnnnaannnnnnm
mnnnnnnnnnnnnnnnnnnnnnnnnnnnnaaaaaaahhhhaaaaahhaaaaaaabaaabaaaaabaaaadddaaaaaagaaagaadhadddddddhhhhhddddddpppapaaapppppppppppppppppdddnnnnnahaaaaannnm
mnnnnnnnnnnnnnnnnnnnnnnnnnnnnaaaaaaaahaaaaaaaaahaaaaabbbbbbaaaaaaaaaaddaahhaaaaaaagaadddddddhddaaaaahaaddppppaaaaaappppppppppppppppppdhhnnhaaaaaaaannm
mnnnnnnnnnnnnnnnnnnnnnnnnnnaaaaaaaaaaaaaaaaaaaahaaaaabaaaabaaaaabahaaaddaaaaaagaaagaahhddahaaaaaaaaaahaddpppppaaaaapppppppppppaapppppppdddaaaahaaaannm
mnnnnnnnnnnnnnnnnnnnnnnnnnnaaahhhaaaaaahhhhhaaahhhaaabaaaabaaaaabhaaaaahdaaahagggggaaahhhhaaaahddhaaadddhpppppaaaaapppppppaaaapapppppppphaaaaahaaaannm
mnnnnnnnnnnnnnannnnnnnnnaaaahhhhaaaaaaaaaaaaaaahahhaabaaaabaaaaacaahhaahdaaaahhhaaaaaaaaaaaaaahdddaaadappppppppaaappppppppaaaaapppppppppdahaaaaaaaannm
mnnnnnnnnnnnnnaaaaaaaaaaaaaaaahhhahhhhhaaaaaaaaaahhaabaaaabaaaaabaahhaaddaaahhbbbbbbbbbbbbbaaaahddaaaddppppppppaapppppppppppaaapppppppppddhaaaaaaaaaam
mnnnnnnnnnnnnnaaaaaaaaaaaaaaahhhhhhaaaaaaaaaaaaaaaaaabbbbbbbbbbbbaaaaaadddhdddbaaabaabaaaabaaaahddhahddppppppppppppppppppppaaaappppppppdddaaaaaaaaaaam
mnnnnnnnnnnnnnaaaaaaaaaaaaaaahhaaaaaaaaaaaaaaaaaaaaaabaaaabaabccbhhaaaadddhhddaaaabaabaaaacaaaaaddhaaddppppppppppppppppppppaaaappppppdhaaahaaaaahhaaam
mnnnnnnnnnnnnnnaaaaaaaaaaaaaaaaahaaaaaaaaaaaaaaaaaaaabaaaabaabccbhhahddaadddddbbbabaabaaaabaaaddddhahddpppppppppppppppppppppppppppppddhaaaaaaaaahhaaam
mnnnnnnnnnnnnnnnnaaaaaaaaaaaaaaaaaaaaaaaaaaaaaaaaaaaabaaaabaabbbbhahaddaaaadddbaaaaaabaaabbaaaddaaaahadpppppppppppppppppppppppppppppdahaaaaaaaahahaaam
mnnnnnnnnnnnnnnnaaaaaaaaaaaaaaaaaaaaaaaaaaaaaaaaaaahabbbbbbaaaaachahdddahaaddhcaaaaaabbbbbahddddhaaaahhdpppppppppppppppppppppppppphdaaahhaaaaaaahhaaam
mnnnnnnnnnnnnnnnaaaaaaaaaaaaaaaaaaaaaaaaaaaaaaaaaaaahddddhbaaaaacddhddhahhaddabaaaaaabhahaaaddddaaaaaahdppppppppppppppppppppppppppddhhaahaahaaaahhaaam
mnnnnnnnnaaaaaaaaaaaaaaaaaaaaaaaaaaaaaaaaaaaaaaaaaaaaaadahbbbbbbbdddddahaaaadacaaaaaabaahaadddddaaaaahadhdddppppppppppdpppppppppdddhhaaahaahhaaaaaaaam
mnnnnnnnnaaaaaaaaaaaaaaaaaaaaaaaaaaaaaaaaaaaaaaaaaaaahhaaadddaaaddddhdddaaaaaabaaaaaabahhaaadddhaaaaahaddahddpppppppppddddhdppdpddhaaaaaaahhhhaaahaaam
mnnnnnnnnaaaaaaaaaaaaaaaaaaaaaaaaaaaaaaaaaaaaaaaaaaaahhaaddddaadddahadddaahhaabbbbbbbbaaaaaadddhhaaaahaahhadhpdppddhdddddhaddhdppdaahaaaaaahhhaaahaaam
mnnnaaaaaaaaaaaaaaaaaaaaaaaaaaaaaaaaaaaaaaaaaaaaaaahhhhahggaggaggdahahddaahhaabccbaaabaahhadddhhaaaaahhahhahhddddddhadadhhaaaddddhhaaaaaaaahhhaahhaaam
mnnaaaaaaaaaaaaaaaaaaaaaaaaaaaaaaaaaaaaaaaaaaaaaaaahhaaadgaaaaaagaaaahddaaaaadbccbaaabddhhhdddhaaaaaaahaaaaaahhddhahahdahhahaahhdhaaaaaaaahahhhahhaaam
mnaaaaaaaaaaaaaaaaaaaaaaaaaaaaaaaaaaaaaaaaaaaaaaaahhhaahdgaaaaaagaaaaaaadaaahdbbbbbbbbdddddahddddhaaaaaaaaaaaaahhhhaaahhaaaaaahahaaaaaaaaaaaahhhaaaaam
mnaaaaaaaaaaaaaaaaaaaaaaaaaaaaaaaaaaaaaaaaaaaaaaaaaahaahhgaaaaaaghaaaaaddaaahahdhddddhhddddhaaahadahhaaaaaaaaahhahhaaaaaaaaaaaaaaaaaaaaaaaaaaaaaaaaaam
maaaaaaaaaaaaaaaaaaaaaaaaaaaaaaaaaaaaaaaaaaaaaaaaaaaaaaaagaaaaaaghhaaahdaahhdbbbbbbbbbbcbbbcbbhadaaaahaaaaaaaaaaaaaaaaaaaaaaaaaaaaaaaaahaaaaaaaaaaaaam
maaaaaaaaaaaaaaaaaaaaaaaaaaaaaaaaaaaaaaaaaaaaaaaaaaaahhaagaaaaaagdaaadahaaahdbaaaabaabaaaaaaabhhhahaaaaaaaaaaaaaaaaaaaaaaaaaaaaaaaaaaaahaaaaaaaaaaaaam
maaaaaaaaaaaaaaaaaaaaaaaaaaaaaaaaaaaaaaaaaaaaaaaaaaaaahaaggggggggdhhadaaahdddaaaaabaabaaaaaaacadhaaaaaaaaaaaaaaaaaahhaaaaaaaaaaaaahhhhaaaaaaaaaaaaaaam
maaaaaaaaaaaaaaaaaaaaaaaaaaaaaaaaaaaaaaaaaaaaaaaaaabaaaahaahhhhddddhddddahdbbbaaaabaabaaaaaaabaddaaahhaaaaaaaaaaaaaaaaaaaaaaaaaaaaaahaaaaaaaaaaahhaaam
maaaaaaaaaaaaaaaaaaaaaaaaaaaaaaaaaaaaaaaaaaaaaaaaabbbeebbbbbbbdddhddddddhhdbcbaaaabaabaaaaaaacaadhhhhhaaaaaaaaaaaaaahaaaaaaaaaaaaaaahhhaaaaaahaaaaaaam
maaaaaaaaaaaaaaaaaaaaaaaaaaaaaaaaaaaaaaaaaaaaaaaaaabeeeebfffffdddaaddhdddahbcbaaaabaabaaaaaaabaadahhhaaaaaaaaaaaaaaaaaahaaaaaaaaaaaahhhhaaaaahaaaaaaam
maaaaaaaaaaaaaaaaaaaaaaaaaaaaaaaaaaaaaaaaaaaaaaaaaabeeeeffffffhadddddaaddhhbcbaaaabaabbbbbbbbbaadhhhhaaaahhhaaaaaaaaaahhhaaaaaaaaaaaaahhaahhhaaaaaaaam
maaaaaaaaaaaaaaaaaaaaaaaaaaaaaaaaaaaaaaaaaaaaaaaaaabeeeeffffffhhddddaaaaadhbbbbbbbbaabaaaabhhaaddaaaaaaahhhhaahaaaaaaaaaaaaaaaaaaaaaaaaaaahhhaaaaaaham
maaaaaaaaaaaaaaaaaaaaaaaaaaaaaaaaaaaaaaaaaaaaaaaaaabeeeeffffffahadadaaahadhbabaaaaaaabaaaabhhddddhaaaaaahaaaaaaaaaaaaaaaahaaaaaaaaaaaaaaaaaaaaaaaaahhm
maaaaaaaaaaaaaaaaaaaaaaaaaaaaaaaaaaaaaaaaaaaaaaaaaabeeeeffffffaaddadaaahadababaaaaaaabaaaabaddddaaaaaaaahaaaaaaaaaaaaaaaaaaaaahhhaaahaaaaaaaaaaaaaahdm
maaaaaaaaaaaaaaaaaaaaaaaaaaaaaaaaaaaaaaaaaaaaaaaaaabeeeeffffffhdddadaaahddabbbbbbbbcbbbbbbbhddhaaaaaaaaaaaaaaaaaaaaaaaaaaaahaahhaaaaaaaaaaaaaaaahahddm
maaaaaaaaaaaaaaaaaaaaaaaaaaaaaaaaaaaaaaaaaaaaaaaaaabeeeebfffffadhadddahaddabaaaaabaaaaaaaaaaddahaaaaaaaaaahhhhaaaaaaaaaaaaahhahhaaaaaaaaaaaaaahahdddom
maaaaaaaaaaaaaaaaaaaaaaaaaaaaaaaaaaaaaaaaaaaaaaaaabbbeebbbbbbbdddddddaaddhhbaaaaabahaaaaadddddahaaaaaaahaahhhhaahaaaaaaaaaaaaaaaaaaaaaaaaaaaahhhhddpom
maaaaaaaaaaaaaaaaaaaaaaaaaaaaaaaaaaaaaaaaaaaaaaaaaabaaaaahdddddddaddaaaddaabbaaaabhddhhddddhaaaaaaaaaaahaaaaaahaaaaahaaahaaaaaaaaaaaaaaaaahahahhadppom
maaaaaaaaaaaaaaaaaaaaaaaaaaaaaaaaaaaaaaaaaaaaaaaaaaaaaaaaaddhddddaaaahadaahabbbbbbdddddddhahaahhaaaaaaahhhahhahaaaaaaahhhaaaaaaaaaaahaaaaaaaddddddooom
maaaaaaaaaaaaaaaaaaaaaaaaaaaaaaaaaaaaaaaaaaaaaaaaaaaaaaaaaaahhddaaaaahadaaaaahahhaadddddddhaaaaahhhaaaaahhahhaaaaahhaahaaaaaaaaaaaaahahahhddpddddpooom
maaaaaaaaaaaaaaaaaaaaaaaaaaaaaaaaaaaaaaaaaaaaaaaaaaaaaaaaaaahhaaaaaaaahddddddaaaaddddhadddhaaaaahhhhhhaaahaaaaaaaaaaaahhaaaaaaaaahhaaahhhhddpppddpooom
maaaaaaaaaaaaaaaaaaaaaaaaaaaaaaaaaaaaaaaaaaaaaaaaaaaaaaaaaaaaaaaaaaaaaddddddaaaaaddhdhadhhaaaaaaaaaaaahhhhhhhaaaaaaaaaaaaaaaaahaahhddddddddppoooooooom
maaaaaaaaaaaaaaaaaaaaaaaaaaaaaaaaaaaaaaaaaaaaaaaaaaaaaaaaaaaaaaaaaaaaaaahhadhahddddddhaaaaaaaahhhaaaaaaaahhhhaaaaaaaaaaaaaaaahahahaddddddpppooooooooom
maaaaaaaaaaaaaaaaaaaaaaaaaaaaaaaaaaaaaaaaaaaaaaaaaaaaaaaaaaaaaaaaaaaaaaaaaadhdhhaahddaaahaaaaaahhaaaaaaaaaaaaaaaaaaaaaahaaaaahadddddddpoooooooooooooom
maaaaaaaaaaaaaaaaaaaaaaaaaaaaaaaaaaaaaaaaaaaaaaaaaaaaaaaaaaaaaaaaaaaaaaaaaahhaaaaddaaaaahaaaaaaaaaaaaaahaaaaaaaaaaaaaaahhdddhhdddddddoooooooooooooooom
maaaaaaaaaaaaaaaaaaaaaaaaaaaaaaaaaaaaaaaaaaaaaaaaaaaaaaaaaaaaaaaaaaaaaaaaaaaaaaahddaaaahhhaaaaaaaaaaaahhaahaaaaaaaahhadahdddhddddddoooooooppooooooooom
maaaaaaaaaaaaaaaaaaaaaaaaaaaaaaaaaaaaaaaaaaaaaaaaaaaaaaaaaaaaaaaaaaaaaaaaaaaaaaahdaaddahhhaaaaaaaaaaaahhaaaaaaaaaaahddddhddddddddddoooooopppddpoooooom
maaaaaaaaaaaaaaaaaaaaaaaaaaaaaaaaaaaaaaaaaaaaaaaaaaaaaaaaaaaaaaaaaaaaaaaaaaaaaaaadhaddaaahaaaaaaaaaaaaahaaaaaaaaaaahddddddpoododdpooooooopdddddpooooom
maaaaaaaaaaaaaaaaaaaaaaaaaaaaaaaaaaaaaaaaaaaaaaaaaaaaaaaaaaaaaaaaaaaaaaaaaaaaaaaaaaaddhaaaaaaaaahahhhaaaaaaaaaaahhahddddpppoooooooooooooopddhhddddddpm
maaaaaaaaaaaaaaaaaaaaaaaaaaaaaaaaaaaaaaaaaaaaaaaaaaaaaaaaaaaaaaaaaaaaaaaaaaaaaaaaaadddhhhaaaaaaaaahhhaaaaaaaaaaahhadddddpppoooooooooooooooddhaahaaaddm
maaaaaaaaaaaaaaaaaaaaaaaaaaaaaaaaaaaaaaaaaaaaaaaaaaaaaaaaaaaaaaaaaaaaaaaaaaaaaaaaahdddddddaaaaahahhahhaaaaaaaahaahhddpddpooooooooooooooooodhaaahaaaddm
maaaaaaaaaaaaaaaaaaaaaaaaaaaaaaaaaaaaaaaaaaaaaaaaaaaaaaaaaaaaaaaaaaaaaaaaaaaaaaaaahhddddddaaaahhhahahaaaaaaahhddddddddoooooooooooooooooddddaaaahahhadm
maaaaaaaaaaaaaaaaaaaaaaaaaaaaaaaaaaaaaaaaaaaaaaaaaaaaaaaaaaaaaaaaaaaaaaaaaaaaaaaaaaahdddddhaahhahhaahhahaaaahhdpdddddoooooooooooooodddddhhaaaaaaahhhdm
maaaaaaaaaaaaaaaaaaaaaaaaaaaaaaaaaaaaaaaaaaaaaaaaaaaaaaaaaaaaaaaaaaaaaaaaaaaaaaaaaaaddddddhaaaaaaaaahaaaaaaahddpddppoooooooooooooooddddhhhhhaaaaaaaham
maaaaaaaaaaaaaaaaaaaaaaaaaaaaaaaaaaaaaaaaaaaaaaaaaaaaaaaaaaaaaaaaaaaaaaaaaaaaaaaaaahadhdddaaaaaaaaahhaaaaaaahdddppdpoooooooooooooddddaahhaaaaaaaaaahnm
maaaaaaaaaaaaaaaaaaaaaaaaaaaaaaaaaaaaaaaaaaaaaaaaaaaaaaaaaaaaaaaaaaaaaaaaaaaaaaaaaahhdahaaaaaaaaaaaaaaaaaaaahahddddppooooooooooddddddhhhhnnnnnnnnnnnnm
maaaaaaaaaaahhhhadddddaaddaaaaaaaaaaaaaaaaaaaaaaaaaaaaaaaaaaaaaaaaaaaaaaaaaaaaaaaaahhaaaadddhaaaaaaaaaaaaaaahaahddpdpoooooooooodhddddaannnnnnnnnnnnnnm
maaaaaaaaaaahhddaaaaahaaddaaaaaaaaaaaaaaaaaaaaaaaaaaaaaaaaaaaaaaaaaaaaaaaaaaaaaaaaahhaaaddddddaaaaaaaaahaaaaaahhadpppoooooooooohahhhaaannnnnnnnnnnnnnm
maaaaaaaaaahhhdddddddaddddaaaaaaaaaaaaaaaaaaaaaaaaaaaaaaaaaaaaaaaaaaaaaaaaaaaaaaaaaaaaahddddddhaaaaaaahhhhhaaaddddooooooooooooddaaaaaaannnnnnnnnnnnnnm
maaaaaaaaadddddddddhhaaddddaaaaaaaaaaaaaaaaaaaaaaaaaaaaaaaaaaaaaaaaaaaaaaaaaaaaaaaaaaaaahdddddhhaaahaahaaddhadddddooooooooodddddaaaaaannnnnnnnnnnnnnnm
maaaaaaaaaddbbbbbiibbbiibbdaaaaaaaaaaaaaaaaaaaaaaaaaaaaaaaaaaaaaaaaaaaaaaaaaaaaaaaaaaaahhddddddaaaaaahahdddhdddddoooooooppoddhhaaannaannnnnnnnnnnnnnnm
maaaaaaaahddbfffbiiiiiiiibhaaaaaaaaaaaaaaaaaaaaaaaaaaaaaaaaaaaaaaaaaaaaaaaaaaaaaaaaaaaaaaaahdhdaaaaaahdddddddddddooooopppppdahaannnnnnnnnnnnnnnnnnnnnm
maaaaaaaaaaabfffbiiiiiiiiihaddaaaaaaaaaaaaaaaaaaaaaaaaaaaaaaaaaaaaaaaaaaaaaaaaaaaaaaaaaaahhhddhaaaahahdoooooooooooooooppdhhdahannnnnnnnnnnnnnnnnnnnnnm
maaaaaahaahabfffbiiiiiiiiiaadddaaaaaaaaaaaaaaaaaaaaaaaaaaaaaaaaaaaaaaaaaaaaaaaaaaaaaaaaaahdddddahaaaaddoooooooooooddpppdddahhhannnnnnnnnnnnnnnnnnnnnnm
maaaaaahddhhbbfbbbfbbbccbbddaadaaaaaaaaaaaaaaaaaaaaaaaaaaaaaaaaaaaaaaaaaaaaaaaaahaaaaaaaahdddddddahahddooooooooooodddddddaadaaannnnnnnnnnnnnnnnnnnnnnm
maaaaadhhdhhbffffffffffffbddaaaddaaaaaaaaaaaaaaaaaaaaaaaaaaaaaaaaaaaaaaaaaaaaaahaahhhaaaaadddhdddhdddppooooooooopoddhahhhaaaaaannnnnnnnnnnnnnnnnnnnnnm
maaaaaahhadabbbbffffbffffbdhhadaaaahaaaaaaaaaaaaaaaaaaaaaaaaaaaaaaaaaaaaaaaaaaaahhdddahhaaahdaddddddddpoooooooppppdaahhhaaaaannnnnnnnnnnnnnnnnnnnnnnnm
maaaaaaaahddbfffffffbfffbbdddddadddahahhaaaaaaaaaaaaaaaaaaaaaaaaaaaaaaaaaaaaaahhhhddddhhahhddddddddpppooooodddpdppdhaaaaaaannnnnnnnnnnnnnnnnnnnnnnnnnm
maaaaaadddddbffbffffbbbbbbdhddddddddddhhaaaaaaaaaaaaaaaaaaaaaaaaaaaaaaaaaaaaaahhdddddddhdddddpddddppppoooppdadhddddhaaaaaaannnnnnnnnnnnnnnnnnnnnnnnnnm
maaaaaaddddhbffbffffjjbccbadhdddddhaddhaaaaaaaaaaaaaaaaaaaaaaaaaaaaaaaaaaaaaaahhhddpddddddddddddddoopppoppdahhaaahhhaaaaaaannnnnnnnnnnnnnnnnnnnnnnnnnm
maaaaaaaddhhbbfbbccbbbbbbbdddaddaahhaaddaaaaaaaaaaaaaaaaaaaaaaaaaaaaaaaaaaaaaaahddpddpooooooooooooooopppddhaaaaaaaaaaaaaaaaannnnnnnnnnnnnnnnnnnnnnnnnm
maaaaaaaaahhiaihhdaadddhhidddaadaaaahhddaaaaaaaaaaaaaaaaaaaaaaaaaaaaaaaaaaaaahhhhddddpoooooooooooooooopoddhhaaaaaaaaaaaaaaaannnnnnnnnnnnnnnnnnnnnnnnnm
maaaaaaaaaddiiiiiiiiiiiiiiddhhaaaaaaahddhaaaaaaaaaaaaaaaaaaaaaaaaaaaaaaaaaaaaahhddddooooooooooooooooooppddhhaaaaaaaaaaaaaaaaannnnnnnnnannnnnnnnnnnnnnm
maaaaahhhhddikiadliiaddikidhhhhhaaaaahddhhhaaaaaaaaaaaaaaaaaaaaaaaaaaaaaaaaaaahaddpdoooooooooooooooddpphdhaahaaaaaaaaaaaaaaaaannnnnnaaannannnnnnnnnnnm
maaaaahhadddidihdaiikhdiliddhhhhaaaaaaddaaaaaaaaaaaaaaaaaaaaaaaaaaaaaaaaaaaaaaaaddpoooooooooooooooodhdaadhhhaahaaaaaaaaaaaaaaannnaaaaaaaaannnnnnnnnnnm
maaaaahhhdddiaiaaliihadikihaddhhaaaaaaadddahaaaaaaaaaaaaaaaaaaaaaaaaaaaaaaaaaaaadpppoooodooppppppooddddddaahaahaaaaaaaaaaaaaaaaaaaaaaaaaaannnnnnnnnnnm
maaaahhhhhddiailhhiihddihihdddhhaaaaaaaddhhaaaaaaaaaaaaaaaaaaaaaaaaaaaaaaaaaaaahdppooooopdddddpdpdddddddddhdddaaaaaaaaaaaaaaaaaaaaaaaaaaaannnnnnnnnnnm
maaaahhaddddbiiiiiiiiiiiibddddhhaaaaaaaahhhdaaaaaaaaaaaaaaaaaaaaaaaaaaaaaaaaaahhddoooooppdhdddpddahhhhhaadddddhaaaaaaaaaaaaaaaaaaaaaaaaaaaaaannnnnnnnm
maaaaaaadddddddddddddadddhadddhhaaaaaaaaddadaahaaahhhaaaaaaaaaaaaaaaaaaaaaaaaahhddooooodddhahaddaahhaaaahdaahdaaaaaaaaaaaaaaaaaaaaaaaaaaaaaaannnnnnnnm
maaaaahhhhddddddddhhdddddadhddhaaaaaaahhdddddahahhhhhhaaaaaaaaaaaaaaaaaahhhhhhhhhdoooooopdhaahhaahaaaahahhaaadaaaaaaaaaaaaaaaaaaaaaaaaahaahahhaannnnnm
maaaaahhaaddadddahhhddddddhaddhaaaaaaahhaaddddddddddhhaaaaaaaaaaaaaaaaaahhhhahhdddooooooodddaahahhaaahhaahaaadaadaaaaaaaaaaaaaaaaaaaaaddhdddhhaannnnnm
maaaaaaahhhaadhhhhahaadddddddaaaaaaaaaaahaahhhaddddddhaaaaahhhhaaaaaahhahhddddddddooooooodddhhaaaaaaaahhaaahaaahhaaaaaaaaaaaaaaaahhadddddahhdahaannnnm
maaaaaaaaaaaaahhaaaaaadddddddaaaaaaaaaaaaahaaahddddddaaaaaahhaahhaahahhhhaddppddpoooooooodddhaaaaaaaahhhaadaahahhaaaaaaaaaaaaaaaahhadddddaahddaaannnnm
maaaaaaaaaaaaaaaaaaaaaaaaaaaaaaaaaaaaaaaaaaaaaahddddhhaaahhhhhaadaahhaahhdddpoooooooooooopddaaaaaaahhaahaaaahhadhaaaaaaaaaaaaaaahhddaaaaaaadddhaannnam
maaaaaaaaaaaaaaaaahaaaaaaaaaaaaaaaaaaaaaaaaadddhddddhhhaddaahhdddhddaahaadddoooooooooooddddaaaaaaaahhaaaaaaaahaaaaaaaaaaaaaaaaaahdddahaaaaadadhaannnam
maaaaaaaaaaaaaaaaaaaaaaaaaaaaaaaaaaaaaaaaaaadddddpdddhdddddddhddpdddddhhhhddoooooooddddddhaaaaaaaaaaaaaaaaaaaaaahhaaaaaaaaaaahaaaahhhaaaaaaaadaaaaaahm
maaaaaaaaaaaaaaaaaaaaaaaaaaaaaaaaaaaaaaaaaahdpppdppdddddddddddddppddppddddddooooooopddhhhaaaaaaaaaaaaaaaaaaaaaahdhahaaaaaaaaaaaahaaaaaaaaaaaaaaaaaaddm
maaaaaaaaaaaaaaaaaaaaaaaaaaaaaaaaaaaaaaahhhhdpdddppppddddddddddoopddddpddpdooooooooppdhhhaaaaaaaaaaaaaaaaaaaaaaddhddaaaaaaaahaaddhaaaaaaaaaahhahaadddm
maaaaaaaaaaaaaaaaaaaaaaaaaaaaaaaaaaaaaaahaadpddddddddddddpppddooopppddpddppooooooooopddhaaaaaaaaaaaaaaaaaaaaaahdddddaahaahhaahdaaaaaaaaaaaaaahdhaahhdm
maaaaaaaaaaaaaaaaaaaaaaaaaaaaaaaaaaaaaaahaddpddoooooodoooooooooooopppdppdddooooooooopddahaaaaaaaaaaaaaaaaaaaaaahhdddahhaaddddhhaaaaaaaaaaaaaahddaaahdm
maaaaaaaaaaaaaaaaaaaaaaaaaaaaaaaaaaaaaahhhdddddoooooooooooooooooooodddpooooooooooooopdddhaaaaaaaaaaaaaaaaaaaaaaahaaddhhdaddhaaaaaaaaaaaaaaaaaahdhaaahm
maaaaaaaaaaaaaaaaaaaaaaaaaaaaaaaaaaaaaadaahhdppooooooooooooooooooooddddoooooooooooppppddhaaaaaaaaaaaaaaaaaaaaaaaaahhdadddddhhaaaaaaaaaaaaaaaaahaaaaaam
maaaaaaaaaaaaaaaaaaaaaaaaaaaaaaaaaaaaahhddddppooooooooopoooooooooooooodooooooooodddddpddaaaaaaaaaaaaaaaaaaaaaaaaaaaahadhhdaaaaaaaaaaaaaaaaaaaaaaaaaaam
maaaaaaaaaaaaaaaaaaaaaaaaaaaaaaaaaaaaadhhdppppooooodooppppooopoooooooodooooooooodddddpddaaaaaaaaaaaaaaaaaaaaaaaaaaaaahhahaaaaaaaaaaaaaaaaaaaaaaaaaaaam
maaaaaaaaaaaaaaaaaaaaaaaaaaaaaaaaaaaaaddddooooooooodddddpppdddooooooooooooooodppdhhaddhaaaaaaaaaaaaaaaaaaaaaaaaaaaaaaaaaaaaaaaaaaaaaaaaaaaaaaaaaaaaaam
maaaaaaaaaaaaaaaaaaaaaaaaaaaaaaaaaaaahddooooooooooodddhhdddddddoooooooooooooopppphhaaahaaaaaaaaaaaaaaaaaaaaaaaaahahaadaaaaaaaaaaaaaaaaaaaaaaaaaaaaaaam
maaaaaaaaaaaaaaaaaaaaaaaaaaaaaaaaaaaahdpooooooooodpdhahhaadddddodoooppooppddddpdddahhhaaaaaaaaaaaaaaaaaaaaaaaaahhdadhdaaaaaaaaaaaaaaaaaaaaaaaaaaaaaaam
maaaaaaaaaaaaaaaaaaaaaaaaaaaaaaaaaaaadpdooooooopppddahhaaahaadppddddppppdpdhhddddaahhhaaaaaaaaaaaaaaaaaaaaaaaaahhddhhaaaaaaaaaaaaaaaaaaaaaaaaaaaaaaaam
maaaaaaaaaaaaaaaaaaaaaaaaaaaaaaaaaahhdpdooooodpddddhdaaaaaaahddpdddddddpdddhahddhhaaaaaaaaaaaaaaaaaaaaaaaaaadddddddaaaaaaaaaaaaaaaaaaaaaaaaaaaaaaaaaam
maaaaaaaaaaaaaaaaaaaaaaaaaaaaaaaaaahhdpdooooooopddhaaddaahaahhddddddddhddahhaaaahhaaaaaaaaaaaaaaaaaaaaaaaaaadhdddaaaaaaaaaaaaaaaaaaaaaaaaaaaaaaaaaaaam
maaaaaaaaaaaaaaaaaaaaaaaaaaaaaaaaahhhdddooooooopdhhaaaaahdaaahhddddaahhahhaahahhaaaaaaaaaaaaaaaaaaaaaaaaaaahdhdddaaaaaaaaaaaaaaaaaaaaaaaaaaaaaaaaaaaam
maaaaaaaaaaaaaaaaaaaaaaaaaaaaaaaaahhhhddpoooooooddddddahhdddhhhhaahahaaaaaahaaaaaaaaaaaaaaaaaaaaaaaaaaaaaaaahhaadhhaaaaaaaaaaaaaaaaaaaaaaaaaaaaaaaaaam
maaaaaaaaaaaaaaaaaaaaaaaaaaaaaaaaahahhadddooooooddddhhadhdddhhhhhhaahaaaaaaaaaaaaaaaaaaaaaaaaaaaaaaaaaaaaaaaahddddaaaaaaaaaaaaaaaaaaaaaaaaaaaaaaaaaaam
maaaaaaaaaaaaaaaaaaaaaaaaaaaaaaaaaaahhhdddoooooopdddddddadddhaaaaaaaaaaaaaaaaaaaaaaaaaaaaaaaaaaaaaaaaaaaaaaaahadddhhaaaaaaaaaaaaaaaaaaaaaaaaaaaaaaaaam
maaaaaaaaaaaaaaaaaaaaaaaaaaaaaaaaaaaaaahddddooooppdddddddahdaaaaaaaaaaaaaaaaaaaaaaaaaaaaaaaaaaaaaaaaaaaaaaaaaahdddahaaaaaaaaaaaaaaaaaaaaaaaaaaaaaaaaam
maaaaaaaaaaaaaaaaaaaaaaaaaaaaaaaaaaaaaahddddddoooppdddpppdddhaaaaaaaaaaaaaaaaaaaaaaaaaaaaaaaaaaaaaaaaaaaaaaaaaaddddaaaaaaaaaaaaaaaaaaaaaaabbbbbaaaaaam
maaaaaaaaaaaaaaaaaaaaaaaaaaaaaaaaaaaaaaahaadddoooppppooopddhhaaaaaaaaaaaaaaaaaaaaaaaaaaaaaaaaaaaaaaaaaaaaaaaaaahhddhaaaaaaaaaaaaaaaaaaaaaabaaabaaaaaam
maaaaaaaaaaaaaaaaaaaaaaaaaaaaaaaaaaaaaaaaahhdpooopppoooopddhhhhaaaaaaaaaaaaaaaaaaaaaaaaaaaaaaaaaaaaaaaaaaaaaaaahadddaaaaaaaaaabbbbbaabbbbbbbbbbaaaaaam
maaaaaaaaaaaaaaaaaaaaaaaaaaaaaaaaaaaaaaaahhadddooooooooopdahahhaaaaaaaaaaaaaaaaaaaaaaaaaaaaaaaaaaaaaaaaaaaaaaaahahadhaaaaaaaaabaaabaabaaaaaaaabaaaaaam
maaaaaaaaaaaaaaaaaaaaaaaaaaaaaaaaaaaaaaahhhddddooooooooopdddaddaaaaaaaaaaaaaaaaaaaaaaaaaaaaaaahhahaaaaaaaaaaaaadddddhaaaaaaaaabaaaaaabaaaaaaaabaaaaaam
maaaaaaaaaaaaaaaaaaaaaaaaaaaaaaaaaaaaaaahaadddpoooooooooooddddhaaaaaaaaaaaaaaaaaaaaaaaaaaaaaaahhdddhaahdaaaaaahdddddaaaaaaaaaabaaabaabaaaaaaaabaaaaaam
maaaaaaaaaaaaaaaaaaaaaaaaaaaaaaaaaaaaaaahahddpdpdddpoooooodppddadaaaahhaaaaaaaaaaaaaaaaaaaahaadaadddhdddaaaaaahdhhaaaaaaaaaaaabbbbbaabaaaaaaaabaaaaham
mhaaaahhhaaaaaaaaaaaaaaaaaaaaaaaaaaaaahhhhhddppddddppoooooooopddhaahhhhahhaaaaaaaaaaaaaaaaahhddddddhhaaaaaaaaaahhhaaaaaaaaaaaaaaaaaaabbaabbbabbaaaaaam
mhaaaaaaaaaaaaahhhhaaaaaaaaaaaaahhhahhdddahdddddhhddpoooooooooddhhahhaaaahaaaaaaaaaaahhaaaaaaaddhhhhaaahhahhhhaahaaaaaaaaaaahhhaaaaaahaaaaaaaaaaaahdam
mahhahhaaaaaaaahhaahadaaaaaaaaaahhhhahhahhhhhhhhahdpddooooooooddhhhaaaaaahhhhaaaaahaaaaahaaaahddhhdaaaahhadahhaaaaaaaahhaaaahhhaaaaahhhaaaaaaaahaahdhm
mdhdahhaaaaaaaahhddddddaahhhhaahaddddhddddhhhaaaahhhdooooooooodaaaaddaddahhhhhaaaahaddaahaahhhhhhadaahhaaaaaaaddddaaahhhahhaahdaahahaahaaaaahahhaddddm
mhddhhhhhaadaahhdddddddhhaahhhhdddddhhhdddaaaaaaddhddoooooooooddhddddhhhahaddaaahhaaddddhhdddhhhaahhhaaaddahhdddhdaaadhhhdhdhahhaadhddahhaahdhaddddddm
miiiiiiiiihahddadhiiiiiiiiiiaiiiiiiiiiiddddaiiaaddiddpddffffoffdiiiiiiahaaaiddiihhaaiddddaaiiiiiiidiiiiaddiiiiiiiiiihaiiiiiadddiiiiiidddhadhiiiiiiiiim
miiihiiiiiiihdddiiiiiiiiihhahddiiiiiiiiiiiiaiadhdahdddddpddffooddihddhhdddaaddihhahhiiiihdiiiddiiddiiidaiiiiiiiididhhaiiiiihdddaiiiiiiiddhdhiiiiiiiiim
midaaiiiiiiiiiiiiiiiiiiiiiiihddaiiiiiiiiiiiiiddddadiiiiddpfffofdddddahhdddddddahhdhhhiiiiiiiiddiiddiiiiihdhiiiiiiiddhiiiiiihdahdiiiiiiiiiiiiiiiiiiiiim
miadihiiiiiiiiiiiiiiiddiiiiihddiiiiiiiiiiiiiiddhdddddddddpooffpdddiihadaahhhhdhiiddddiiiidiiiddiiiiiiiiidaaiiiiiiiiihhddhiiiiiahhiiiiiiiiiiiiiiihiiiim
miiidaidhiidddiiiiiiiddddaiidhhiiiiiiiidddiiiahaddidddfffffofppdddiiiadhhhaahiiiidhahiiiddidiiiiiiihhhaahaddiiiiiiiiiiiiiiiiiiddddhhahddiahddhdadiiiim
mhhhhaahddhdddaahddhahddhadadahhadhhddddhahhhhaahhddddooooooopppddhddddhhaaahhhdhhaahhddddddhhaaaahhahaahahhhddahahaahdahhddddhahaahhhddddddhhddddddhm
mahhaaahddddahhaaddhhaahhhdhaaaaaddadhhahaahhhaahhdddoooooooopppddhhhhahhaaaahhahaaddddhhahhhaaaaaaaaaaaaahahddaddhdhhaaahhdddaaaaahaahhhaddaahhhahham
mhhaaaaaaaaahhhaaaaaaahhhahhaaaaaaadaahaahhhaddddddddpooooooopppdhaahhhhaaaaaaaaaaaddddhaaaaaaaaaaaaaaaaaaaaahhaaaaahaaaahahhhaaaaaaaaaahaaaaaaaaahham
maaaaaaaaaaahaaaaaaaaaahaaaaaaaaaaaaaaaaaaaaadddddpppppoooooopppdddahhhhaaaaaaaaaaaddddadddaaaaaaaaaaaaaaaaaaaaaaahaaaaaaaaaaaaaaaaaaaaaaaaaaaaaaaaaam
mmmmmmmmmmmmmmmmmmmmmmmmmmmmmmmmmmmmmmmmmmmmmmmmmmmmmmmmmmmmmmmmmmmmmmmmmmmmmmmmmmmmmmmmmmmmmmmmmmmmmmmmmmmmmmmmmmmmmmmmmmmmmmmmmmmmmmmmmmmmmmmmmmmmmm
"}
