"a" = (/turf/simulated/floor/exoplanet/snow,/area/space)
"b" = (/turf/simulated/wall/wood,/area/space)
"c" = (/turf/simulated/floor/plating,/area/space)
"d" = (/turf/simulated/floor/asteroid,/area/space)
"e" = (/turf/simulated/floor/tiled/techfloor,/area/space)
"f" = (/turf/simulated/floor/wood,/area/space)
"g" = (/turf/simulated/wall/r_wall,/area/space)
"h" = (/turf/simulated/floor/exoplanet/grass,/area/space)
"i" = (/turf/simulated/floor/exoplanet/concrete,/area/space)
"j" = (/turf/simulated/floor/tiled/freezer,/area/space)
"k" = (/obj/structure/pit/closed/grave,/obj/structure/gravemarker/cross,/turf/simulated/floor/exoplanet/grass,/area/space)
"l" = (/obj/structure/pit/closed/grave,/obj/structure/gravemarker/cross,/turf/simulated/floor/exoplanet/snow,/area/space)
"m" = (/turf/unsimulated/wall,/area/space)
"n" = (/turf/unsimulated/mineral,/area/space)
"o" = (/turf/simulated/floor/exoplanet/water/shallow,/area/space)
"p" = (/turf/simulated/floor/exoplanet/ice,/area/space)
"q" = (/turf/simulated/floor/lino,/area/space)
"r" = (/obj/structure/table/rack/special,/turf/simulated/floor/tiled/techfloor,/area/space)
"s" = (/turf/simulated/floor/tiled/old_tile,/area/space)
"t" = (/turf/simulated/floor/tiled/dark,/area/space)
"u" = (/obj/structure/monolith{name = "SCP-1328-1-RU"},/turf/simulated/floor/asteroid,/area/space)
"v" = (/obj/structure/monolith{name = "SCP-1328-1-RU"},/turf/simulated/floor/exoplanet/grass,/area/space)
"w" = (/obj/structure/monolith{name = "SCP-1328-1-RU"},/turf/simulated/floor/exoplanet/snow,/area/space)
"x" = (/turf/simulated/floor/tiled/techfloor/grid,/area/space)
"y" = (/obj/structure/table/steel,/turf/simulated/floor/tiled/techfloor,/area/space)
"z" = (/obj/structure/table/rack/special,/turf/simulated/floor/tiled/techfloor/grid,/area/space)
"A" = (/obj/structure/table/steel_reinforced,/turf/simulated/floor/tiled/techfloor/grid,/area/space)

(1,1,1) = {"
mmmmmmmmmmmmmmmmmmmmmmmmmmmmmmmmmmmmmmmmmmmmmmmmmmmmmmmmmmmmmmmmmmmmmmmmmmmmmmmmmmmmmmmmmmmmmmmmmmmmmmmmmmmmmmmmmmmmmmmmmmmmmmmmmmmmmmmmmmmmmmmmmmmmmm
mnnnnnnnnnnnnnnnnnnnnnnnnnnnnnnnnnnnnnnnnnnnnnnnnnnnnnnnnnnnnnnnnnnahahhaaaaaaaaaaaaaaaaaaaaaaaaaaaaaaahahhhnnnnnnnnnnnnnnnnnnnnnnnnnnnnnnnnnnnnnnnnnm
mnnnnnnnnnnnnnnnnnnnnnnnnnnnnnnnnnnnnnnnnnnnnnnnnnnnnnnnnnnnnnnnnnnahaaaaaaaaaaaaaaaaaaaaaaaaaaaaaaaaaaaaaahnnnnnnnnnnnnnnnnnnddnnnnnnnnnnnnnnnnnnnnnm
mnnnnnnnnnnnnnnnnnnnnnnnnnnnnnnnnnnnnnnnnnnnnnnnnnnnnnnnnnnnnnnnnnhhhaaaaaaaaaaaaaaahaaaaaaaaaaaahhhaaaaahhaaannnnnnnnnnnnnnnnddddnnnnnnnnnnnnnnnnnnnm
mnnnnnnnnnnnnnnnnnnnnnnnnnnnnnnnnnnnnnnnnnnnnnnnnnnnnnnnnnnnnnnnnnahhaaaaaaaaaaaaaaaaaaaaaaaaaaaahhhaaaaaaahhhnnnnnnnnnnnnnnnnddddaadnnnnnnnnnnnnnnnnm
mnnnnnnnnnnnnnnnnnnnnnnnnnnnnnnnnnnnnnnnnnnnnnnnnannnnnnnnnnnnnnhhhhaaaahhaahaaaaahahhaahaaaaaaaahaaaaaaaaahhhnnnnnnnnnnnnndaaaaddadaaaannnnnnnnnnnnnm
mnnnnnnnnnnnnnnnnnnnnnnnnnnnnnnnnnnnnnnnnnnnnnannannnnnnnnnnnnnnhhaahahhhahaaaaaaaaaaaahaaaaaaaaaaaaaaaaaaahhhnnnnnnnnnnnnadaaaannaaaadaannnnnnnnnnnnm
mnnnnnnnnnnnnnnnnnnnnnnnnnnnnnnnnnnnnnnnnnnnhaaaaannnnnnnnnnnnaaaaaaaahhhahaaaaaaaahaaaaaaaaaaaaaahaaaaaaaaaahannnnnnnnnnaaaaaannnnnddddannnnnnnnnnnnm
mnnnnnnnnnnnnnnnnnnnnnnnnnnnnnnnnnnnnnnhnnhhaaaahhaannnnnnnnnnaaaaaaaaaaaaaaaaaaaaaaaaahaaaaaaaaaaaaaaaaaaaahhannnnnnnnnnanadddannddddaaannnnnnnnnnnnm
mnnnnnnnnnnnnnnnnnnnnnnnnnnnnnnnnnnnnnnhnhaaaaaahhaannnnnnnnaaaaaahhaaaaaaaahhaahaaaaaahaaaaaaaahhaaaaaaaaaahhaannnnnnnnnaaaaddadddaddaadannnnnnnnnnnm
mnnnnnnnnnnnnnnnnnnnnnnnnnnnnnnnnnnnnnnhhaaaaaahhaaannnnnnnnnaaaaahhaaaaaaaaaaaaaaaaaaaaaaaaaaaaaaahhaaaaaaahhannnnnnnddaaadadddddddaaaadannnnnnnnnnnm
mnnnnnnnnnnnnnnnnnnnnnnnnnnnnnnnnnnnnnnahaaaaaahhahaannnnnannaaaaahhaaaaaaaaaahhaaaaaaaaaaahaahaaaahaaaaaaaaaahnnnnnndadddannaaaadddadddddannnnnnnnnnm
mnnnnnnnnnnnnnnnnnnnnnnnnnnnnnnnnnnnnnnaaaaaaaahhahhhhaaanaaaaaaahaaaaahhhaaaaaaaaaaaaaaaaaaaaahhaaaaaaaaaaaaaaannnnnddddaannaaaddddndnnnddannnnnnnnnm
mnnnnnnnnnnnnnnnnnnnnnnnnnnnnnnnnnnnnnnhhhaaaaahhaahhhaaaaaaaaaaahaaaaaahhaaaaaaaaaaaaaaaaaaaaahhaaaaaaaaaaahaaanndnaddnnnnnnndaaddaannnnddannnnnnnnnm
mnnnnnnnnnnnnnnnnnnnnnnnnnnnnnnnnnnnnnnhaaaaaaaaaaaaaaaahaaaaahaaaaahaaahhhaaaaaahaaaaaaaaaaaaaaaaaaaaaaaahhaaaaaaddddannnnnnnnaaddannnnnaaannnnnnnnnm
mnnnnnnnnnnnnnnnnnnnnnnnnnnnnnnnnnnnnhaaaaahhhaaaaaaaaaaaaaaaahaaaaaahaaahhaaaaaaahaaaaahhaaaaaaaaaaaaaaahaddddhhhaaddnnnnnnnnnnadaaddnddddannnnnnnnnm
mnnnnnnnnnnnnnnnnnnnnnnnnnnnnnnnnnnnaaaaaaaahhaaaaaaaaaaaaahhhhaaaaaahaaaaaaaahhaahaahaahaaaaaaaaaaaaaaaahhdapppdddddannnnnnnnadaaaaadddaddnnnnnnnnnnm
mnnnnnnnnnnnnnnnnnnnnnnnnnnnnnnnnnnnaaaaahhahaaaaaaaaaahaaaaaahaaaaaaaaaaaaaaahhahhaaaaaaaaaaaaaaaaaaahhahhpppppppddaannnnnnnnddaaaannndnnannnnnnnnnnm
mnnnnnnnnnnnnnnnnnnnnnnnnnnnnnnnnnnnaaaaahhaaaaaaaaaaaahaahaahhaaaaaaaaaaaaaaaaaaaaaaaaaaahhahaaaaaadddahadppppppppddaannnnnddddddnnnnnnnnnnnnnnnnnnnm
mnnnnnnnnnnnnnnnnnnnnnnnnnnnnnnnnnnnaaaaaaaaaahaaaaaaaahaahhhhaahhhaaaaahaahhhaaaaaahhaaahhhhhaaaahaddddddhpppppappdhaaaannnadddannnnnnnnnnnnnnnnnnnnm
mnnnnnnnnnnnnnnnnnnnnnnnnnnnnnnnnnnaaahaaaaahhhaahaaaaaaaaaahhhaaaaaaaaaaaahddddaaahahaaahhaaaaaaahdddppppppppaaaappddahhnadddddnnnnnnnnnnnnnnnnnnnnnm
mnnnnnnnnnnnnnnnnnnnnnnnnnnnaaaaaaaahhhaaaahhhaaaaaaaaaaaaaaaaaaaaaaaaaaahahdddddddaddhaaaaaaaaaaaaddpppppppppaaaappdddhhhddddadnnnnnnnnnnnnnnnnnnnnnm
mnnnnnnnnnnnnnnnnnnnnnnnnnnaahaaaaaahhhhaaahhaaaaaaaaaaaaaaaahaaaaaaaaaadddddhaddddddddaaaaaaaaahhhddppppppppppaaappppppdppddhadnnnnnnnnnnnnnnnnnnnnnm
mnnnnnnnnnnnnnnnnnnnnnnnnnaahhhaahaaahhaaaaaaaaaaaaaaaaaaaaaahaaaaaaaahhddddhaadddddddddahhaaaaaahhppppppppppppappppppppppppddaahnnnnnnnnnnnnnnnnnnnnm
mnnnnnnnnnnnnnnnnnnnnnnnnnnahaaaaahaahhhaaaaaaaaahhaaaaaaaaaaaaaaaaaadddddahhaaddddhhaadaaaaaaaaahdpppppppppppppppapppppppppddhhaannnnnnnnnnnnnnnnnnnm
mnnnnnnnnnnnnnnnnnnnnnnnnnnaaaaaaaaaaahhhaaaaaaaahhaaaaaaaaaaaaaaaaaadddhaaaaaaaahaaaaaaaaaaaaaaahddppppppppppppppppppppppppddddhahdnnnnnnnnnnnnnnnnnm
mnnnnnnnnnnnnnnnnnnnnnnnnnnnaahhaaaaaaahhaaaaaahhaaaaabbbbbaaaaaaaadddddhahaaaaaaaaaaddaaahhaaaahaddpppppppppppappppppppppppppppddddnnnnnnnnnnnnnnnnnm
mnnnnnnnnnnnnnnnnnnnnnnnnnnnnaaaaaaaaaahaaaaahhahaaaaabjjjbbcbcbbaadddddhahhhagggggaaddahahdddaahaadddhhpppppppaapppppppppppppppppddnnnnnnnnnaannnnnnm
mnnnnnnnnnnnnnnnnnnnnnnnnnnnnaaaaaaahhhhaaaaahhaaaaaaabjjjbqqqqqbaaaadddaaaaaagrregaadhadddddddhhhhhddddddpppapaaapppppppppppppppppdddnnnnnahaaaaannnm
mnnnnnnnnnnnnnnnnnnnnnnnnnnnnaaaaaaaahaaaaaaaaahaaaaabbbjbbqqqqqqaaaaddaahhaaaeeeegaadddddddhddaaaaahaaddppppaaaaaappppppppppppppppppdhhnnhaaaaaaaannm
mnnnnnnnnnnnnnnnnnnnnnnnnnnaaaaaaaaaaaaaaaaaaaahaaaaabffffbqqqqqbahaaaddaaaaaagyergaahhddahaaaaaaaaaahaddpppppaaaaapppppppppppaapppppppdddaaaahaaaannm
mnnnnnnnnnnnnnnnnnnnnnnnnnnaaahhhaaaaaahhhhhaaahhhaaabffffbqqqqqbhaaaaahdaaahagggggaaahhhhaaaahddhaaadddhpppppaaaaapppppppaaaapapppppppphaaaaahaaaannm
mnnnnnnnnnnnnnhnnnnnnnnnaaaahhhhaaaaaaaaaaaaaaahahhaabffffbqqqqqcaahhaahdaaaahhhaaaaaaaaaaaaaahdddaaadappppppppaaappppppppaaaaapppppppppdahaaaaaaaannm
mnnnnnnnnnnnnnahhhhahaaaaaaaaahhhahhhhhaaaaaaaaaahhaabffffbqqqqqbaahhaaddaaahhbbbbbbbbbbbbbaaaahddaaaddppppppppaapppppppppppaaapppppppppddhaaaaaaaaaam
mnnnnnnnnnnnnnaahhhahaaaaaaaahhhhhhaaahhaaaaaaaaaaaaabbbbbbbqbbbbaaaaaadddhdddbeeebffbffffbaaaahddhahddppppppppppppppppppppaaaappppppppdddaaaaaaaaaaam
mnnnnnnnnnnnnnaaaaaahaaaaaaaahhaaaaaaahhaaaaaaaaaaaaabffffbqqbccbhhaaaadddhhddeeeebfffffffcaaaaaddhaaddppppppppppppppppppppaaaappppppdhaaahaaaaahhaaam
mnnnnnnnnnnnnnnaahahhaaaaaaaaaaahaaaahhhaaahaaaaaaaaabfffffqqbccbhhahddaadddddbbbebffbffffbaaaddddhahddpppppppppppppppppppppppppppppddhaaaaaaaaahhaaam
mnnnnnnnnnnnnnnnnaaahhaaahhaaaaaaaaaahhhaaahaaaaaaaaabffffbqqbbbbhahaddaaaadddbffffffbfffbbaaaddaaaahadpppppppppppppppppppppppppppppdahaaaaaaaahahaaam
mnnnnnnnnnnnnnnnhhaaaaaaahhaaaaaaaaaahaaaaaaaaaaaaahabbbbbbqqqqqchahdddahaaddhcffffffbbbbbahddddhaaaahhdpppppppppppppppppppppppppphdaaahhaaaaaaahhaaam
mnnnnnnnnnnnnnnnaaaaaaaaaaaaaahaaaaaaaaaaaaaaaaaaaaahddddhbqqqqqcddhddhahhaddabffffffbhahaaaddddaaaaaahdppppppppppppppppppppppppppddhhaahaahaaaahhaaam
mnnnnnnnnaaaaaaaaaaaaaaaaaaaaaaaaaaaaahhhaaaahhaaaaaaaadahbbbbbbbdddddahaaaadacffffffbaahaadddddaaaaahadhdddppppppppppdpppppppppdddhhaaahaahhaaaaaaaam
mnnnnnnnnaaaaaaaaaaaahaaaaaaaaaaaaaaaahhhaaaaaaaaaaaahhaaadddaaaddddhdddaaaaaabffffffbahhaaadddhaaaaahaddahddpppppppppddddhdppdpddhaaaaaaahhhhaaahaaam
mnnnnnnnnaahhaaaaaaaaaaahaaaaaaaaaaaaahhhaaahahaaaaaahhaaddddaadddahadddaahhaabbbbbjbbaaaaaadddhhaaaahaahhadhpdppddhdddddhaddhdppdaahaaaaaahhhaaahaaam
mnnnaaahahahhaaaaaaaahhaahhaaaaaaahhhaaaaaaaaaaaaaahhhhahggeggeggdahahddaahhaabccbjjjbaahhadddhhaaaaahhahhahhddddddhadadhhaaaddddhhaaaaaaaahhhaahhaaam
mnnaaaahhaaahaaahhahahhahhaaaaaaaahhhahaaaaaaaaaaaahhaaadgeeeeeegaaaahddaaaaadbccbjjjbddhhhdddhaaaaaaahaaaaaahhddhahahdahhahaahhdhaaaaaaaahahhhahhaaam
mnaaaaaaaaahhaaaaaahahhaaaaaaaaaaaaahaahaaaaaaaaaahhhaahdgzezzezgaaaaaaadaaahdbbbbbbbbdddddahddddhaaaaaaaaaaaaahhhhaaahhaaaaaahahaaaaaaaaaaaahhhaaaaam
mnhaaaaaahhhhaaahaaaahaaaaaaaahaaaaahhahaaaaaaaaaaaahaahhgzezzezghaaaaaddaaahahdhddddhhddddhaaahadahhaaahaaaaahhahhaaaaaaaaaaaaaaaaaaaaaaaaaaaaaaaaaam
maaahhaaaaaaaaahhaaaaaahaaaahhhaaaaaaahhhaaaahhaaaaaaaaaagzezzezghhaaahdaahhdbbbbbbbbbbcbbbcbbhadaaaahaahhhaaaaaaaaaaaaaaaaaaaaaaaaaaaahaaaaaaaaaaaaam
mahhhhaaaaaaaaahhaaaahaaaaaahhhhhhaaaahhhaaaahhaaaaaahhaageeeeeegdaaadahaaahdbssssbttbfffffffbhhhahaaaaaahhaaaaaaaaaaaaaaaaaahaaaaaaaaahaaaaaaaaaaaaam
maahaaaaaaaaahhhaaaaaaaaaaaaaahhhhaaaaaaaaaaaahaaaaaaahaaggggggggdhhadaaahdddssssssttffffffffcadhaaaaaaaahaaaahaaaahhaaaahahhaaaaahhhhaaaaaaaaaaaaaaam
maahhaaaaaaaaahhaaaaaaaaaaaaaaaaaaaaaaaaaaaahhhaaaabaaaahaahhhhddddhddddahdbbbssssbttbfffffffbaddaaahhaaaaaaaaaaaaaaaaaaahahhhaaaaaahaaaaaaaaaaahhaaam
maaahaaaaaaaaaaaaaaaaaaaaaaaaaaaaaaaaaaaaaaahhaaaabbbeebbbbbbbdddhddddddhhdbcbssssbttffffffffcaadhhhhhaaaaaaaaaaaaaahaaaaaaahhaaaaaahhhaaaaaahaaaaaaam
maaaaaaaaaaaaaaaaaaahhhaaahaaaaaaaaaaaaaaaaahhaaaaabeeeebfffffdddaaddhdddahbcbssssbttbfffffffbaadahhhaaaaaaaaaaaaaaaaaahaaaaaaahhaaahhhhaaaaahaaaaaaam
maaaaaaaaahhhhaaaaaahhhhhaaaaaaaaaaaaaaaaaaahhaaaaabeeeeffffffhadddddaaddhhbcbssssbttbbbbbbbbbaadhhhhaaaahhhaaaaaaaaaahhhaaaaaahhaaaaahhaahhhaaaaaaaam
maaaaaahhhhhhaaaaahhhhhhhaaaaaaaaaaaaahhaaaaaaaaaaabeeeeffffffhhddddaaaaadhbbbbsbbbttbffffbhhaaddaaaaaaahhhhaahaaaaaaaaaaaaaaaahaaaaaaaaaahhhaaaaaaham
maaaaaaahhaaaaaaaahhhhhhhhhhaaaaaaahhhhhaaaaaaaaaaabeeeeffffffahadadaaahadhbjbtttttttfffffbhhddddhaaaaaahaaaaaaaaaaaaaaaahaaaaaaaaaaaaaaaaaaaaaaaaahhm
maaaaaaaahaaaahaaaahahhhhhhhaaaaaaahhhaaaaaaaahhaaabeeeeffffffaaddadaaahadabjjtttttttbffffbaddddaaaaaaaahaaaaaaaahhhaaaaaaaaaahhhaaahaaaaaaaaaaaaaahdm
maaaaaaahhhaaaaaaaahaaaahaaaaaaaaaaahaaaaaaaahhhhaabeeeeffffffhdddadaaahddabbbbqbbbcbbbbbbbhddhaaaaaaaaaaaaaaaaaaaahaaaaaaahaahhaaaaaaaaaaaaaaaahahddm
maaaaaaaaaaaaaaaaaaaahhaaaaaaaaaaaaahhhhhaaaahhhaaabeeeebfffffadhadddahaddabqqqqqbaaaaaaaaaaddahaaaaaaaaaahaahaaaaahaaaaaaahhahhaaaaaaaaaaaaaahahdddom
maaaaaaaaaaaaaaaaaaaaahaaaaaaaaaaaaaaaaaaaaaahaaaabbbeebbbbbbbdddddddaaddhhbqqqqqbahaaaaadddddahaaaaaaahaaaaahaahaaaaaaaaaaaaaaaaaaaaaaaaaaaahhhhddpom
maaaaaaaaaaaaaaaaaaaaaaaaaaaaahaaaaaaaaaaaaahhaaaaabaaaaahdddddddaddaaaddaabbqqqqbhddhhddddhaaaaaaaaaaahaaaaaahaaaaahaaahaaaaaaaaaaaaaaaaahahahhadppom
mhaaahhaaaaaaaaaaaaaaaaaaaaaaaaaaaaaaaaaaaaaaahaaaaaaaaaaaddhddddaaaahadaahabbbbbbdddddddhahaahhaaaaaaahahaahahaaaaaaahhhaaaaaaaaaaahaaaaaaaddddddooom
mhaaahhaaaahaaaaaaaaaaaaaaahahhaaaaaaaaaaaaaaaaaaaahhaaaaaaahhddaaaaahadaaaaahahhaadddddddhaaaaahhhaaaaaaaaahaaaaahhaahaaaaaaaaaaaaahahahhddpddddpooom
maaaahhaaaaaaaaaahahaaaaahhhahhaaaaaaahhaaaaaaaaaahhhaaaahaahhaaaahhaahddddddaaaaddddhadddhaaaaahaaahaaaahaaaaaaaaaaaahhaaaaaaaaahhaaahhhhddpppddpooom
maahahhaaaaaaaahaaaaaaaaahhhaaaaaaaaaaaaaaaaaahhaahaaaahhhaaaaaaahhaaaddddddaaaaaddhdhadhhaaaaaaaaaaaaahhhhhhaaaaaaaaaaaaaaaaahaahhddddddddppoooooooom
maaahhaaaaaaaaaahhaaaaaaahaaaaaahhaaahaaaaaaaahhaaaaaaahhhhhaaaaahaaaaaahhadhahddddddhaaaaaaaahhhaaaaaaaahhhhaaaaaaaaaaaaaaaahahahaddddddpppooooooooom
maaaaaaaaaaahhhahhaaaaaaahaaaaaahhhhahaaaaahhhaaaaaaaaaaahhhaaaahhhaaaaaaaadhdhhaahddaaahaaaaaahhaaaaaaaaaaaaaaaaaaaaaahaaaaahadddddddpoooooooooooooom
maaaaaaaaaaahhhaaaaaaaaaahhaaaaaaahhahaaaaaaahhhaaaaaaaaaaaaaahahaaahaaaaaahhaaaaddaaaaahaaaaaaaaaaaaaahaaaaaaaaaaaaaaahhdddhhdddddddoooooooooooooooom
maaaahhaaaahaaaaahaaaaaaaaaaaaaaaaaaaaaaaahaaaaaaaaaaaaaaaaaaaaahaaahaaaaaaaaaaahddaaaahhhaaaaaaaaaaaahhaahaaaaaaaahhadahdddhddddddoooooooppooooooooom
maaaaaaaaaaaaaaaaaaaaaaaaaaaaaaaaaaaaaaaaaahaaaaaaahhaaahaaaaaaaaahaaahhaaaaaaaahdaaddahhhaaaaaaaaaaaahhaaaaaaaaaaahddddhddddddddddoooooopppddpoooooom
maahhahaaaaaaaaaaaaaaaaaaaaaaaaaaaaaaaaaaaaaaaaaaaahaduhaaaaaaaaaaaaaahhaahhaaaaadhaddaaahaaaaaaaaaaaaahaaaaaaaaaaahddddddpoododdpooooooopdddddpooooom
maahhhhhahaaaaaaaaaaaaaahhhaaaaaaaahhaaahhahaaaaaaahvhhddhaaaaaaaaaaaaaaaahhhhaaaaaaddhaaaaaaaaahahhhaaaaaaaaaaahhahddddpppoooooooooooooopddhhddddddpm
maahaahhahaaaaaaaaaaaaaahhhaaaaaaaahhaaaaaahhaaaaahahhhdddaaaaaaaaaaaaaaaaahhaaaaaadddhhhaaaaaaaaahhhaaaaaaaaaaahhadddddpppoooooooooooooooddhaahaaaddm
maaaaahhaahhaaaaaahaaahhahhaaaaahhahhaaaaaahaaaaahdaddddduaaahhahaaaaaaaaahhahaaaahdddddddaaaaahahhahhaaaaaaaahaahhddpddpooooooooooooooooodhaaahaaaddm
maaaaahhaahhaaaaaaaaaaaaahhaaaaaahaaaaaaaaahaaaaaahhdhhdddaaaaahhaaaaaaaaahhaaaaaahhddddddaaaahhhahahaaaaaaahhddddddddoooooooooooooooooddddaaaahahhadm
maaaaaaaahhhaaaaaaaaahhaaaaaaaahaaaaaaaahaaaaaaaaahhuhhdwdaaaahhaaaaaaaaaaaaaaaaaaaahdddddhaahhahhaahhahaaaahhdpdddddoooooooooooooodddddhhaaaaaaahhhdm
maaaaaaaaahhaaaaaaaaaaaaaaaaaaaahaaaaaaahhhhahhhaahhdddhhaaaaaaaahhhaahhhaaaaaaaaaaaddddddhaaaaaaaaahaaaaaaahddpddppoooooooooooooooddddhhhhhaaaaaaaham
maaaaaaaaahhaaaaaaaaaaaaaaaaaaaaaahaaaaaaaaaaaaaaaaadhhhhaaaaaaaahahaaahhaaaaaahaaahadhdddaaaaaaaaahhaaaaaaahdddppdpoooooooooooooddddaahhaaaaaaaaaahnm
maahaaaaaaaaaaaaaaaaaaaaaaaahhaaaaaaaaaaaaaahhaaaaaaaaaaaaahhaaaaaahhhahaaaaaaaahaahhdahaaaaaaaaaaaaaaaaaaaahahddddppooooooooooddddddhhhhnnnnnnnnnnnnm
maahahhaaaaahhhhadddddaaddaaaaaaaaaaaaaaaaaahahhhaaaaaaaaaahhaahaaaaaaaaaaaaaaaahaahhaaaadddhaaaaaaaaaaaaaaahaahddpdpoooooooooodhddddaannnnnnnnnnnnnnm
maaahaaaaaaahhddaaaaahaaddaaaaaaahhaahhaaaaaaahhhaaaaaaaaaahaaaaaaaahaaaaaaaaaaahaahhaaaddddddaaaaaaaaahaaaaaahhadpppoooooooooohahhhaaannnnnnnnnnnnnnm
maaahhaaaaahhhdddddddaddddaaaaaahaahaahahaaaahahhaaaaaaaahahaaaaaaaaaaaahhaaaaaaaaaaaaahddddddhaaaaaaahhhhhaaaddddooooooooooooddaaaaaaannnnnnnnnnnnnnm
mhaahhaaaadddddddddhhaaddddaaaaaaahhaaaaaaaaaaaaaaaahahaaaaaaaaaaaaaaaaaaaaahhaaaaaaaaaahdddddhhaaahaahaaddhadddddooooooooodddddaaaaaannnnnnnnnnnnnnnm
mhaaaaaaaaddbbbbbiibbbiibbdaaaaaahaahhhaaaaaaaaaaaaaahhahaaaahaaaaaaahaaaaaaahaaahhaahahhddddddaaaaaahahdddhdddddoooooooppoddhhaaannaannnnnnnnnnnnnnnm
maaaaaaaahddbfffbiiiiiiiibhaaaaaaahhhhhaaaaaaaaaaaahhhaaaaaaaaaaahhhhaaaaaahahaaahhhahaaaaahdhdaaaaaahdddddddddddooooopppppdahaannnnnnnnnnnnnnnnnnnnnm
maaaaaaaaaaabfffbiiiiiiiiihaddaaaaahhhaaaaaahaaaaaaahhaaaaaaaaaaahhaaaaaaaaahhaaahhaaaaaahhhddhaaaahahdoooooooooooooooppdhhdahannnnnnnnnnnnnnnnnnnnnnm
maaaaaahaahabfffbiiiiiiiiiaadddaaaaaaaaaaaaaaaaaaaahahahaaaaaaaaaaaaaaahahaahaahhhhaaaaaahdddddahaaaaddoooooooooooddpppdddahhhannnnnnnnnnnnnnnnnnnnnnm
maaaaaahddhhbbfbbbfbbbccbbddaadaaaaaaaaaaaahhaaaaaaaaaahaaaaahhaaaaaaahhaaaaaaaahaaaaaaaahdddddddahahddooooooooooodddddddaadaaannnnnnnnnnnnnnnnnnnnnnm
maaaaadhhdhhbffffffffffffbddaaaddaaaaaaaaahahaaaaaaahaaaaaaaahhaaaaaaahhhhaahaahaahhhaaaaadddhdddhdddppooooooooopoddhahhhaaaaaannnnnnnnnnnnnnnnnnnnnnm
mahaaaahhadabbbbffffbffffbdhhadaaaahaaaaaahahhhaaaaahaaaaaaaaaaaaaaaahaaaaaaaaaahhdddahhaaahdaddddddddpoooooooppppdaahhhaaaaannnnnnnnnnnnnnnnnnnnnnnnm
mahaaaaaahddbfffffffbfffbbdddddadddahahhaaahahhaaaahhhaaaaaaahaaaaaaaaaaaaaaaahhhhddddhhahhddddddddpppooooodddpdppdhaaaaaaannnnnnnnnnnnnnnnnnnnnnnnnnm
maahaaadddddbffbffffbbbbbbdhddddddddddhhaahaaaaaaaaaahaaaahaahaaaaaaaaaaaaaaaahhdddddddhdddddpddddppppoooppdadhddddhaaaaaahnnnnnnnnnnnnnnnnnnnnnnnnnnm
mhaahaaddddhbffbffffjjbccbadhdddddhaddhahahaaaaaaaaaahhaaaaaahahhaaaahhhaaaaaahhhddpddddddddddddddoopppoppdahhaaahhhaaaaahhnnnnnnnnnnnnnnnnnnnnnnnnnnm
mahhhaaaddhhbbfbbccbbbbbbbdddaddaahhaaddaaaaaaaaaahhahhaaaaaahahhaaaahahaahaaaahddpddpooooooooooooooopppddhaaaaaaaaaaaaaahhannnnnnnnnnnnnnnnnnnnnnnnnm
mahhaaaaaahhiaihhdaadddhhidddaadaaaahhddaaaaaahhhahhaaaaaaaaaaaaaaaaahhhhaaaahhhhddddpoooooooooooooooopoddhhaaaaaaaaaaaaaaahnnnnnnnnnnnnnnnnnnnnnnnnnm
maaaaaaaaaddiiiiiiiiiiiiiiddhhaaaaaaahddhaaaaaahhahaaaaaaaaaaaaaaaaaahhaaaaaaahhddddooooooooooooooooooppddhhaaaaaaaahhaaaaaaannnnnnnnnannnnnnnnnnnnnnm
maaaaahhhhddikiadliiaddikidhhhhhahhaahddhhhaaaahhaaaaahaaaaaaaaaaaaaaaaaaaaaaahaddpdoooooooooooooooddpphdhaahaaaaaaahhaaaaaahhnnnnnnaaannannnnnnnnnnnm
maaaaahhadddidihdaiikhdiliddhhhhahhaaaddaaaaaahhhaaaaaaaaaaaaaaaaaaaaaaahaaaaaaaddpoooooooooooooooodhdaadhhhaahaaaahhhaaaaaaaannnaaaaaaahannnnnnnnnnnm
maaaaaahhdddiaiaaliihadikihaddhhaahhaaadddahaaaaaaaaaaaaahhaaaaaahaaaaaahhahaaaadpppoooodooppppppooddddddaahaahaahhhhhaahhaaaaaaaaahaahhaannnnnnnnnnnm
maaaahahhhddiailhhiihddihihdddhhaaahaaaddhhaaaaaaaaaaaaaaaaaahaaahaaaaaaahhaaaahdppooooopdddddpdpdddddddddhdddaaaaaaahhhhhhaaahhaaahhhaaaannnnnnnnnnnm
maaaahhaddddbiiiiiiiiiiiibddddhhaahhaaaahhhdaaaaaaaaaaaaaaahhhhhhaaaaaaaaaaaaahhddoooooppdhdddpddahhhhhaadddddhaaaaaaahhaaaaaaahahahhhaaaaaaannnnnnnnm
maaaaaaadddddddddddddadddhadddhhaaaaaaaaddadaahaaahhhaaaahaaahhhaaaaaaaaaaaaaahhddooooodddhahaddaahhaaaahdaahdaaaaaahhaaaaaaaaaahaaaaaaaaaaaannnnnnnnm
maaaaahhhhddddddddhhdddddadhddhaaaaahahhdddddahahhhhhhaaahaaaaaaaaaaaaaahhhhhhhhhdoooooopdhaahhaahaaaahahhaaadaaaaaaaahhhaaaaaaaaaaaaaahaahahhaannnnnm
mhhaaahhaaddadddahhhddddddhaddhaaaahaahhaaddddddddddhhahhaaaaaaaaaaaaaaahhhhahhdddooooooodddaahahhaaahhaahaaadaadaaaaaaahaaaahaaaaaaaaddhdddhhaannnnnm
maaaaaaahhhaadhhhhahaadddddddaaaaaaaaaaahaahhhaddddddhahaaahhhhaaaaaahhahhddddddddooooooodddhhaaaaaaaahhaaahaaahhaaaaaaaaaaaaaaaahhadddddahhdahaannnnm
maahaaaaaaaaaahhaaaaaadddddddaaaaaaaahhaaahaaahddddddaahaaahhaahhaahahhhhaddppddpoooooooodddhaaaaaaaahhhaadaahahhaaaaahahaahaaaaahhadddddaahddaaannnnm
maaaaaaaaahaaaaaaaaaaaaaaaaaaaaaaahhahhaaaaaaaahddddhhaaahhhhhaadaahhaahhdddpoooooooooooopddaaaaaaahhaahaaaahhadhaaahhhhaaaaaaaahhddaaaaaaadddhaannnam
maaaahahhaahaaaaaahaahhaaaaahhaaaahhhhhhhaaadddhddddhhhaddaahhdddhddaahaadddoooooooooooddddaaaaaaaahhaaaaaaaahaaaaaaahhaaaaaaaaahdddahaaaaadadhaannnam
maaaaaaaaaaaaaaaaahahahaaaahhaahhhaahhhhaaaadddddpdddhdddddddhddpdddddhhhhddoooooooddddddhaahhhaaaaaaaahahhhaaaahhaaaahaaaaaahaaaahhhaaaaaaaadaaaaaahm
maaahhaahaaaaaaaaaaaaahaaaaaahahhhaahhhhaaahdpppdppdddddddddddddppddppddddddooooooopddhhhaaahhhaaaaaaaahaaaahaahdhahaahhaaaaaaaahaaaaaaaahhaaaaaaaaddm
maaahahahaaaahhaaaahaahaaaaaahaaaaaahaaahhhhdpdddppppddddddddddoopddddpddpdooooooooppdhhhaahhaaaaaaaaahhhaaahaaddhddaaaaaaaahaaddhaaaaahahaahhahaadddm
maaaaahaaaahaahaaaahaaaaaaaaaaahahhaaaaahaadpddddddddddddpppddooopppddpddppooooooooopddhaaahhhaaahhaaahhhaaaaahdddddaahaahhaahdaaaaaaaahahaaahdhaahhdm
maaaaaaaaaahhhaaaaaaaaaaaaaaaaaaaaaaaaaahaddpddoooooodoooooooooooopppdppdddooooooooopddahaahhhaaaaaaahaaaaaaaaahhdddahhaaddddhhaaaaaaaaahhaaahddaaahdm
maaaaaaaaaahahhhaaaaaaaaahhaaaaaahaaaaahhhdddddoooooooooooooooooooodddpooooooooooooopdddhaaaaaaaaaaaaaaaaahaaaaahaaddhhdaddhaaaaaaaaaaaahhaaaahdhaaahm
maaaaaaaaaahaaaaaaaaaaaaahaaaaaaahhhaaadaahhdppooooooooooooooooooooddddoooooooooooppppddhaaaaaaaaaaaaaaaaaaaaaaaaahhdadddddhhaaaahaaahaaaaaaaahaaaaaam
maahaaaaaaaaaaaahaaaaaahaahaaaaahhhhaahhddddppooooooooopoooooooooooooodooooooooodddddpddaaaaaaaaaaahhaaahhaaaahhaaaahadhhdaaaaaaaaaaahaaaaaaaaaahhaaam
maaaaaaaaaaaaaaaaaaaaaaahaaaaaaaaahhaadhhdppppooooodooppppooopoooooooodooooooooodddddpddaaahhhhaaaaahhhahhaaaahhhhaaahhahaaaaahaaaaaaaaaaaaaaaaaaaaham
maahaaaaahaaaaaaaaaaaaaahaaaahhhhhhaaaddddooooooooodddddpppdddooooooooooooooodppdhhaddhaahhahhaaaaaaahhaaaaaaaaaaaaaaaaaaahhhaaaaaaaaaaahaaaaaaaaaaham
mhhaaaaaahahaaaahaaaaaaaaaaaaaaaaaaaahddooooooooooodddhhdddddddoooooooooooooopppphhaaahaahaaaaaaaaaaahhaaahaaaaahahaadaaaaaahaaaahhaahhhaaaahaaahaaaam
maahaaaaaaahhahhaaaaaaaaaaaahaaaaaaaahdpooooooooodpdhahhaadddddodoooppooppddddpdddahhhahaahaaaaaaaaaaahaaahaaaahhdadhdaaaaaahaaahhaaaahhhhahhaaahaaaam
mhhhhaaaaaaaaaaaaaaaahaaaahhahaaaaaaadpdooooooopppddahhaaahaadppddddppppdpdhhddddaahhhaahhhaaaaaaaaaaaaaahhaaaahhddhhaaaaaaaaaaaaaaaaaahhhaaaaaahaaaam
maaahhaaaaaaaaaaaaaaaaaaaaaahhaaaaahhdpdooooodpddddhdaaaaaaahddpdddddddpdddhahddhhaaaaaaahaaaaaaaaaaaaaaahhadddddddaaaaahhaaaaaaaaaahaahhhaaaaaaaaaaam
maaahhaaaaaaaaahaaaaaaaaaaaaahahaaahhdpdooooooopddhaaddaahaahhddddddddhddahhaaaahhaaaaaaahaaaaaaaaaaahaaahhadhdddaaaaaaaaaaaaaaaaaahaaaaaaahahaahhaaam
maaaaaaaaaaaaaahaaaaaaaaaahaaaahaahhhdddooooooopdhhaaaaahdaaahhddddaahhahhaahahhaaaaahhhaaaahaaahhhaahaaaaahdhdddaaaahhaaahhaaaaahahaaaaaaaaaaaahhaaam
maaaaaaaaaaaaaaaaaaaaaaaaaaaaahaaahhhhddpoooooooddddddahhdddhhhhaahahaaaaaahaaaaaaaaahaaaaaaaaaahhhaaaahhaaahhaadhhaahaaaahhaaaaaaaaaaaaaaaaaaaaaaaaam
maaaaaaaaaaaaaaaaaaahaaaaaaaaahaaahahhadddooooooddddhhadhdddhhhhhhaahaaaaaaaaaaaaaaaahaahhaaaaaaaaaahhhaaaaaahddddaaaaahahhhaaaaaaaaaaaahaaaaaaaaaaaam
mahhaaahaaaaahhhaaaaaaaaaaaaaaaaaaaahhhdddoooooopdddddddadddhaaaaaaaaaaaaaaaaaaaaaaaaaaahhaaaaaaaaaahahaaaaaahadddhhaaahhhahaaaahhaaahhaaaaaaaaaaahaam
maaaaaahaahaahhhaaaaaaaahhhaaahaaahaaaahddddooooppdddddddahdaaaaaaaaaaaaaaaahhaaaahhaaahhhahhaaaahhahahahhaaaahdddahaaahaaaaaaaaaaaaaaaaaaaaaaaahhhaam
maahaaahaahaahhaaaahhhhhhaaaaaaaaaaaaaahddddddoooppdddpppdddhaaaaaaaaaaaaaaahhahhhhhaaahhaaahhaaaaaahhaahhaaaaaddddaaaaaaaaaaaaaaaaaaaaaaabbbbbaaaaaam
maahhhaaaahahhaaaaaaaaahhaahhaaaaaaaaaaahaadddoooppppooopddhhaaaaaaahhaaaahahhahhaahaaaaaaaahhaaaaaahaaahaaaaaahhddhaaaaaaaaaaaaaaaaaaaaaabjjjbaahhaam
mahaaaaaaaaahhaahaaaaaaaahhaaaaahhaahhaaaahhdpooopppoooopddhhhhaaaaaaaaaaahhhaaaaaahaaaaaaaaaaaaaaaaaahahaahaaahadddaaaaaaaaaabbbbbaabbbbbbbjbbhhahaam
mahahahaaahaaaaahaaaaaaaaaahaaaaaaaaaaaaahhadddooooooooopdahahhaaaaaaaaaaaaaaaaaahhaaaaaaahaaaaaaaaaaaahaaaaaaahahadhaaaahaaaabzzzbaabqqqqqqqqbhaahaam
maahhaaaaahaaahhhaaahhhaaaaaaaaaaaahhaaahhhddddooooooooopdddaddaaaaaaaaaahaaaaaaaaaaaaaaahhaaahhahaaaaaaaaaahaadddddhaaahaaaaabxxxxaabqqqqqqqqbahhhaam
maahaaaaaaaaaahhhaaahaaaahhhaaaaahhhhaaahaadddpoooooooooooddddhaaaaaaaaaaaaaaaaaaaaaaaahhhhaaahhdddhaahdaaaaaahdddddahaahhaaaabzAzbaabqqqqqqqqbaaaaaam
maaaaaaaaaaaaaaaaaaaaaaaaaaaaaahhahaaaaahahddpdpdddpoooooodppddadaaaahhaaaaaaaaaaaaaaaaaaaahaadaadddhdddaaaaaahdhhaaahahhaaaaabbbbbaabqqqqqqqqbhaaaham
mhaaaahhhaaaaaaaaaaaaaahaaaaaaaaaaaaaahhhhhddppddddppoooooooopddhaahhhhahhaaaaaaaaaaaaaaaaahhddddddhhaaaaaaaaaahhhaaaaaaaaaaaaaaaaaaabbccbbbqbbaaaaaam
mhaaaaaaaaaaaaahhhhaaaaaaaaaaaaahhhahhdddahdddddhhddpoooooooooddhhahhaaaahaaaaaaaaaaahhaaaaaaaddhhhhaaahhahhhhaahaaaaaaaaaaahhhaaaaaahaaaaaaaaaaaahdam
mahhahhaaaaaaaahhaahadaaaaaaaaaahhhhahhahhhhhhhhahdpddooooooooddhhhaaaaaahhhhaaaaahaaaaahaaaahddhhdaaaahhadahhaaaaaaaahhaaaahhhaaaaahhhaaaaaaaahaahdhm
mdhdahhaaaaaaaahhddddddaahhhhaahaddddhddddhhhaaaahhhdooooooooodaaaaddaddahhhhhaaaahaddaahaahhhhhhadaahhaaaaaaaddddaaahhhahhaahdaahahaahaaaaahahhaddddm
mhddhhhhhaadaahhdddddddhhaahhhhdddddhhhdddaaaaaaddhddoooooooooddhddddhhhahaddaaahhaaddddhhdddhhhaahhhaaaddahhdddhdaaadhhhdhdhahhaadhddahhaahdhaddddddm
miiiiiiiiihahddadhiiiiiiiiiiaiiiiiiiiiiddddaiiaaddiddpddffffoffdiiiiiiahaaaiddiihhaaiddddaaiiiiiiidiiiiaddiiiiiiiiiihaiiiiiadddiiiiiidddhadhiiiiiiiiim
miiihiiiiiiihdddiiiiiiiiihhahddiiiiiiiiiiiiaiadhdahdddddpddffooddihddhhdddaaddihhahhiiiihdiiiddiiddiiidaiiiiiiiididhhaiiiiihdddaiiiiiiiddhdhiiiiiiiiim
midaaiiiiiiiiiiiiiiiiiiiiiiihddaiiiiiiiiiiiiiddddadiiiiddpfffofdddddahhdddddddahhdhhhiiiiiiiiddiiddiiiiihdhiiiiiiiddhiiiiiihdahdiiiiiiiiiiiiiiiiiiiiim
miadihiiiiiiiiiiiiiiiddiiiiihddiiiiiiiiiiiiiiddhdddddddddpooffpdddiihadaahhhhdhiiddddiiiidiiiddiiiiiiiiidaaiiiiiiiiihhddhiiiiiahhiiiiiiiiiiiiiiihiiiim
miiidaidhiidddiiiiiiiddddaiidhhiiiiiiiidddiiiahaddidddfffffofppdddiiiadhhhaahiiiidhahiiiddidiiiiiiihhhaahaddiiiiiiiiiiiiiiiiiiddddhhahddiahddhdadiiiim
mhhhhaahddhdddaahddhahddhadadahhadhhddddhahhhhaahhddddooooooopppddhddddhhaaahhhdhhaahhddddddhhaaaahhahaahahhhddahahaahdahhddddhahaahhhddddddhhddddddhm
mahhaaahddddahhaaddhhaahhhdhaaaaaddadhhahaahhhaahhdddoooooooopppddhhhhahhaaaahhahaaddddhhahhhaaaaaaaaaaaaahahddaddhdhhaaahhdddaaaaahaahhhaddaahhhahham
mhhaaaaaaaaahhhaaaaaaahhhahhaaaaaaadaahaahhhaddddddddpooooooopppdhaahhhhaaaaaaaaaaaddddhaaaaaaaaaaaaaaaaaaaaahhaaaaahaaaahahhhaaaaaaaaaahaaaaaaaaahham
maaaaaaaaaaahaaaaaaaaaahaaaaaaaaaaaaaaaaaaaaadddddpppppoooooopppdddahhhhaaaaaaaaaaaddddadddaaaaaaaaaaaaaaaaaaaaaaahaaaaaaaaaaaaaaaaaaaaaaaaaaaaaaaaaam
mmmmmmmmmmmmmmmmmmmmmmmmmmmmmmmmmmmmmmmmmmmmmmmmmmmmmmmmmmmmmmmmmmmmmmmmmmmmmmmmmmmmmmmmmmmmmmmmmmmmmmmmmmmmmmmmmmmmmmmmmmmmmmmmmmmmmmmmmmmmmmmmmmmmmm
"}
